11 11 11 11 11 11 11 11 11 11 11 11 11 11 11 11 11 11 11 11 11 11 11 11 11 11 11 11
0 0 0 0 0 0 0 0 0 0 0 0 0 0 0 0 0 0 0 0 0 0 0 0 0 0 0 0
0 0 0 0 0 0 11 0 11 0 7 5 5 5 5 5 5 5 5 5 5 5 5 5 5 5 8 0
0 0 0 0 0 0 11 0 0 0 3 1 1 1 1 1 1 1 1 1 1 1 1 1 1 1 4 0
0 0 0 0 0 0 0 0 11 0 3 1 1 1 1 1 1 1 1 1 1 1 1 1 1 1 4 0
0 0 0 0 0 0 0 11 0 0 3 1 1 1 1 1 1 1 1 1 1 1 1 1 1 1 4 0
0 0 0 0 0 0 0 0 0 0 3 1 1 1 1 1 1 1 1 1 1 1 1 1 1 1 4 0
0 0 0 0 0 0 0 11 0 0 3 1 1 1 1 1 1 1 1 1 1 1 1 1 1 1 4 0
0 0 0 0 0 0 11 0 0 0 3 1 1 1 1 1 1 1 1 1 1 1 1 1 1 1 4 0
0 0 0 0 0 0 11 0 11 0 3 1 1 1 1 1 1 1 1 1 1 1 1 1 1 1 4 0
0 0 0 0 0 0 0 0 0 0 3 1 1 1 1 1 1 1 1 1 1 1 1 1 1 1 4 0
0 0 0 0 0 0 0 11 0 0 3 1 1 1 1 1 1 1 1 1 1 1 1 1 1 1 4 0
0 0 0 0 0 0 0 11 0 0 3 1 1 1 1 1 1 1 1 1 1 1 1 1 1 1 4 0
0 0 0 0 0 0 11 0 11 0 9 6 6 6 6 6 6 6 6 6 6 6 6 6 6 6 10 0
0 0 0 0 0 0 0 0 0 0 0 0 0 0 0 0 0 0 0 0 0 0 0 0 0 0 0 0
11 11 11 11 11 11 11 11 11 11 11 11 11 11 11 11 11 11 11 11 11 11 11 11 11 11 11 11